11111111111111
1C0000010A0E01
1P00C001111011
11111101111011
1C111100000001
10000001111111
11111111111111
