1111111111111111111
1P0111E00A01CCC0001
110111110001CCC1101
1100000000111111101
1111100000000000001
1111111111011111111
1111111111011111111
1CCCCCCC00011111111
1CCCCCCC11111111111
1111111111111111111